111111111111111
1C0000C100000P1
101101101101101
1C000C010001101
1011101101001C1
100E10010000001
1010C00001CC101
100C00C11100C01
111111111111111