1111111111
1000000001
100C000001
1000000001
10000P0001
1000000001
10C000E001
1111111111