11111111
10000001
100C0001
10000001
10000P01
10000001
10C00001
11111111